1111111
1111122
1111022
1111000
1111001
2222011
1111111
1111001
1111110
0000001
1111001
1111111
1110111
1111100